4 25 15
###############
# *  * p*b* * #
# # # # #*# # #
#* *   *    * #
#*# #*# #*# # #
# *  *  1  2  #
# #*# #*# # # #
#*  **  *  *  #
# #*# #*# #*#*#
#**  3  ** 5 *#
#*# # #*#*# # #
#  * * * * *  #
# #*# # #*# #3#
#   4*  *  *  #
#*#*# # # # #*#
#* * *   * * *#
# # # #*# # #*#
#  * 4 * * * *#
#*# # # # # # #
#* * *4  *** 5#
# # # # # # # #
#  * *   *    #
#*# # #*# #*# #
#  x *  5*    #
###############