2 13 31
###############################
#    *  * 1  * p **  *   *  * #
# #*#*#*# #*#*# #*#*# #*# # #x#
# *  *  ** * *** * **  3 *  **#
#*# # # # # #*#*# # # #*# #*#*#
#  * * * * f*   1*  ***  2    #
#*# # # # # #2# # # # #*#*#*# #
#  * 4 * *    *  *   3    *   #
#*# # # # #*#*#*# #*# #*#*# # #
#   *   **  *  * *  **  *   * #
#*#*#*#*#*# # #*#*# # #*# # # #
#  x   *  4  * *     4  *  *  #
###############################