3 13 31
###############################
#p  *  * b* * * ** 3    **   *#
# #*#*# #*# # # #*#*# # # #*# #
#* *   *    *   *  * *  *     #
#*# #*# #*# # # # #*#*# # # # #
#    *  *  4  *   *   *  **  2#
#*#*# #*# # # # # # # # #*#*# #
#   **  *  1   s   * 5** * x *#
#*# # # # # #*# # # #*#*# # # #
# *  4  **   * *   * * * *    #
# # # #*#*# # #*# # # # # # # #
#* x * * * *   *** * *   * 3  #
###############################