99 25 15
###############
#b   p   #  1 #
#b#       *## #
#b          # #
#b#         #2#
#b        #####
#b#       *   #
#f        # # #
#f#       #  3#
#f        #  ##
#f#       #*###
#f        #   #
#f#       # # #
#f        # 4 #
#f#       # # #
#f        #   #
#s#   #*###*###
#s    #       #
#s#   # # # # #
#s    #   5   #
#s#   # # # # #
#s    #       #
#s#   # # # # #
#s    #       #
###############