1 13 31
###############################
#                             #
#     bbbbbffffffssssssssss   #
#                             #
#           p                 #
#f       *    *               #
#        ******               #
#*  *    *    *    *          #
#        *    *  * *          #
#       x     2               #
#          x                  #
#                             #
###############################